111111111111111111
11000000C000000011
111101100011110001
10E10010001XX10001
11110010C011110C01
10X00010000001X001
11P0000000C0000011
111111111111111111
